5 10
1111111111
10F0100101
100110P001
10F0000101
1111111111