1111111111
1000100101
100110P001
1000000101
1111111111