7 10
1111111111
1000100101
1F0110P001
10F00B0101
1000000001
10000B0001
1111111111