7 10
1111111111
1000100101
1F0110P001
10F00C0101
1000000001
10000C0001
1111111111