5 10
1111111111
1000100101
1F0110P001
10F0000101
1111111111